................
.rrr......ggg...
................
......b.........
................
.....ppp........
................
................
................
.....rrggpb.....
................
gggg............
................